Урок 10:

Простое настоящее время - Presente de indicativo
Я делаю это когда у меня есть свободное время - Lo hago cuando tengo tiempo libre 

Простое будущее время - Futuro simple
Я буду там завтра - Estaré allí mañana 

Простое прошедшее время - Pretérito indefinido 
Я решил изучать испанский - Decidí aprender español 

Прошедшее длительное время (или происходило периодически) - Pretérito imperfecto 
Я часто ходил туда со своими друзьями - 
A menudo iba allí con mis amigos 

Настоящее совершенное время - Pretérito perfecto
Я никогда не был в Англии - Nunca he estado en Inglaterra 

Будущее совершенное время - Futuro perfecto 
Они уедут к завтрашнему - Se habrán ido para mañana 

Давно прошедшее время (предпрошедшее время) - Pretérito pluscuamperfecto
Я уже поговорил с ним перед тем как поговорить с ней - Ya había con él antes de hablar con ella 

Он сказал, что понимает это - Él dijo que lo entendía
Он сказал мне что уже понял это - Él me dijo que lo había entendido 
Мы идём на рынок - Vamos al mercado 
Мы играли в футбол каждый день - Jugaba al fútbol todos los días 
Я вернулся домой, поужинал и в десять вечера лёг спать - Regresé a casa, cené y a las diez de la noche me acosté 
Он хочет чтобы я написал письмо - Él quiere yo escriba una carta 
Я сомневаюсь, что он говорит по китайски - Dudo que él hablo chino 
Это возможно, что пойдёт дождь - Es posible que llueva 
Когда я закончу заниматься, я посмотрю это видео - Cuando termine de estudiar, veré este vídeo 
Прошлой ночью я не мог заснуть - Anoche no pude dormir 
В прошлом месяце мы были в Испании - El mes pasado estuvimos en España 
Вчера я ходил на пляж - Ayer fuí a la playa 
Я ходил на пляж сегодня - He ido a la playa hoy

Мы были в Испании в прошлом году - Estuvimos en España el año pasado 
Я был в Испании два раза - He estado en España dos veces
Я посетил Испанию дважды - He visitado España dos veces
Я читал эту книгу вчера - Leí este libro ayer 
Я читал эту книгу сегодня - He leído este libro hoy 
Я показал ему это видео, но он сказал мне, что уже смотре его - Le mostré este vídeo pero me dijo que ya lo había visto 
Я надеюсь что ты всё понял - Espero que hayas entendido todo 
Я надеюсь что ты выучишь испанский язык очень скоро - Espero que aprendas la lengua española muy pronto 
Я надеюсь что ты выучишь испанский очень скоро - Espero que aprendas español muy pronto