Урок 8:

Настоящее совершенное время / ближайшее прошедшее время - Pretérito perfecto de indicativo
Форма образования - Haber + ... ado / ido / ido

Покупать - Comprar
Я купил - Yo he comprado 
Ты купил - Tú has comprado
Он купил - El ha comprado
Мы купили - Nosotros hemos comprado
Вы купили - Vosotros habéis comprado
Они купили - Ellos han comprado

На этой неделе - Esta semana
В этом месяце - Este mes
В этом году - Este año
Сегодня утром - Esta mañana 
В этом веке - Este siglo
Сегодня - Hoy
Уже - Ya
Ещё не - Todavía no
Никогда - Nunca

Он купил машину на этой неделе - Él ha comprado un coche esta semana
Я начал изучать испанский в этом году -
He empezado a aprender español este año
Я проснулся очень рано сегодня - Me he despertado muy temprano hoy

Сегодня я встал в семь - Hoy me he levantado a las siete
У меня было много работы на этой неделе - He tenido mucho trabajo esta semana 
Я уже добрался до пляжа - Ya he llegado a la playa 
Я никогда не путешествовал на самолёте - Nunca he viajado en avión 
Я ещё не добрался до пляжа - Todavía no he llegado a la playa 

Я уже купил эту вещь - Ya he comprado esta cosa 
Я ещё не купил эту вещь - Todavía no he comprado esta cosa 
Я ещё не написал это сообщение - Todavía no he escrito este mensaje 
Я уже прочёл твоё письмо - Ya he leído tu carta 

Будущее совершенное время - Futuro perfecto
Форма образования - Haber + ... ado / ido / ido
Я скажу - Yo habré hablado
Ты скажешь - Tú  habrás hablado 
Он скажет - Él habrá hablado
Мы скажем - Nosotros habremos hablado
Вы (мн.) скажете - Vosotros habréis hablado
Они скажут - Ellos habrán hablando

Заканчивать - Terminar
Я закончу это к завтрашнему - Lo habré terminado para mañana
Я закончу свою работу к декабрю - Habré terminado mi trabajo para diciembre
Я закончу эту работу к завтрашнему - Habré terminado este trabajo para mañana
Я поем перед тем как уйти - Habré comido antes de salir

Ты уже закончишь в восьми? - ¿Ya habrás terminado para a las ocho?
Я поговорю с ним к пяти - Habré hablando con él para las cinco 

Предпрошедшее время / Давно прошедшее время - Pretérito pluscuamperfecto
Форма образования - Haber ... ado / ido / ido

Я работал - Yo había trabajado 
Ты работал - Tú habías trabajando 
Он работал - Él había trabajado 
Мы работали - Nosotros habíamos trabajado
Вы работали - Vosotros habíais trabajado 
Они работали - Ellos habían trabajado

Сказать - Decir 
Произошло - Pasar
Я сказал ему что это уже произошло - Le dije que esto ya había pasado 
Я знал, что я совершил ошибку - Sabía que había cometido un error

Когда он вернулся домой, я уже сделал это - Cuando él llegó a cas, ya lo había hecho 
Когда он вернулся, я уже закончил свою работу - Cuando él regresó, ya había terminado mi trabajo
Когда она позвонила мне, я уже поел - Cuando ella me llamó, ya había comido