Урок 6:

Работать - Trabajar
Я буду работать - Yo trabajé
Ты будешь работать - Tú trabajarás
Он будет работать - Él trabajará
Мы будем работать - Nosotros trabajaremos
Вы будете работать - Vosotros trabajaréis
Они будут работать - Ellos trabaján

Я буду работать больше - Trabajaré más
Ты будешь работать меньше - Trabajarás menos
Он будет работать намного больше - Él trabajará mucho mas
Мы будем работать вместе - Nosotros trabajaremos juntos 
Вы будете работать в этом месте - Trabajaréis en este lugar
Они будут работать более профессионально - Trabaján más profesionalmente

Я посещу Испанию в следующем году - Visitaré España el año que viene / el próximo año 
Я посещу Соединённые Штаты в следующем месяце - Visitaré los Estados Unidos el mes que viene / el próximo mes
Я буду там завтра - Estaré allí mañana
Завтра у меня будет свободное время - Mañana tendré tiempo libre
У тебя будет эта возможность - Tendrás esta oportunidad


Я сделаю это - Lo are
Я сделаю это для тебя - Lo aré por ti 
Ты увидишь это потом - Lo verás después
Мы увидим это скоро - Lo veremos pronto
Я закончу это в этом году - Lo terminaré este año 


Простое настоящее время - Presente de indicativo 
Я часто делаю это - Lo ago a menudo 

Просто будущее время - Futuro simple
Я поеду в эту страну скоро - Iré a este país pronto 
Я думаю что поеду в Испанию в следующем году - Creo que iré a España el año que viene / el próximo año

Простое прошедшее время - Pretérito indefinido 
Вчера - Ayer
Позавчера - Anteayer
В прошлом году - El año pasado
На прошлой неделе - La semana pasada
В прошлом месяце - El mes pasado 

Я говорил - Yo hablé
Ты говорил - Tú hablaste 
Он говорил - Él habló
Мы говорили - Nosotros hablamos
Вы говорили - Vosotros hablasteis
Они говорили - Ellos hablaron
Я говорил с ним - Hablé con él
Мы говорили по испански вчера - Hablamos español ayer
Они говорили так быстро - Ellos hablaron tan rápido
Мой друг купил машину в прошлом месяце - Mi amigo compró un coche el mes pasado 
Я выучил / я изучал - Yo aprendí
Ты выучил - Tú aprendiste 
Он выучил - Él aprendió 
Мы выучили - Nosotros aprendimos
Вы выучили - Vosotros aprendisteis
Они выучили - Ellos aprendieron

Я выучил испанский в прошлом году - Aprendí español el año pasado
Они изучали испанский заграницей - Ellos aprendieron español en el extranjero 
Я выучил эти слова - Aprendí estás palabras 
Он продал свою машину - Él vendió su coche 
Они продали свой дом - Ellos vendieron su casa

Я жил - Yo viví
Ты жил - Tú viviste 
Он жил - Él vivió 
Мы жили - Nosotros vivimos
Вы жили - Vosotros vivisteis
Они жили - Ellos vivieron

Я жил в Испании в прошлом году - Viví en España el año pasado 
Мы жили в этом городе - Vivimos en esta ciudad
Они жили в Латинской Америке два года назад - Ellos vivieron en América Latino hace dos años 

Идти / ехать - ir
Я пошёл туда - Fui allí 
Я пошёл в это место - Fuí a este lugar 

Иметь - tener
У меня были некоторые ошибки - Tuve algunos errores 
Я не ходил туда - No fuí allí 
Ты ходил туда вчера? - ¿Fuiste allí ayer?